1111111111111111111111111111111111
1P000001000000000001C0001000100001
11111101101011101111110000C0010101
1110000100001100C11000100000101001
1E00110001111000000010001000000111
1111111111111111111111111111111111